1111111111111111111111111111111111111111111111111111111111111111111111111111111111111111111111111111
1000000000000000000000000000000000000001111111111111111111111111111111111111111111111111111111111111
1000000000000000000000000000000000000001111111111111111111111111111111111111111111111111111111111111
100000000000000000E000000000000000000001111111111111111111111111111111111111111111111111111111111111
1000000000000000000000000000000000000001111111111111111111111111111111111111111111111111111111111111
1000000000000000000000000000000000000001111111111111111111111111111111111111111111111111111111111111
1000000000000000000000000000000000000001111111111111111111111111111111111111111111111111111111111111
1000000000000000000000000000000000000001111111111111111111111111111111111111111111111111111111111111
1000000000000000000000000000000000000001111111111111111111111111111111111111111111111111111111111111
1000000000000000000000000000000000000001111111111111111111111111111111111111111111111111111111111111
1000000000C000000P0000000000000000000001111111111111111111111111111111111111111111111111111111111111
1000000000000000000000000000000000000001111111111111111111111111111111111111111111111111111111111111
1000000000000000000000000000000000000001111111111111111111111111111111111111111111111111111111111111
1000000000C00000C00000000000000000000001111111111111111111111111111111111111111111111111111111111111
1000000000000000000000000000000000000001111111111111111111111111111111111111111111111111111111111111
1000000000000000001100000000000000000001111111111111111111111111111111111111111111111111111111111111
1000000000000000001100000000000000000001111111111111111111111111111111111111111111111111111111111111
100000000000000C001100000000000000000001111111111111111111111111111111111111111111111111111111111111
1000000000000000001100000000000000000001111111111111111111111111111111111111111111111111111111111111
1000000000000000001100000000000000000001111111111111111111111111111111111111111111111111111111111111
1111111111111111111111111111111111111111111111111111111111111111111111111111111111111111111111111111
1111111111111111111111111111111111111111111111111111111111111111111111111111111111111111111111111111
1111111111111111111111111111111111111111111111111111111111111111111111111111111111111111111111111111
1111111111111111111111111111111111111111111111111111111111111111111111111111111111111111111111111111
1111111111111111111111111111111111111111111111111111111111111111111111111111111111111111111111111111
1111111111111111111111111111111111111111111111111111111111111111111111111111111111111111111111111111
1111111111111111111111111111111111111111111111111111111111111111111111111111111111111111111111111111
1111111111111111111111111111111111111111111111111111111111111111111111111111111111111111111111111111
1111111111111111111111111111111111111111111111111111111111111111111111111111111111111111111111111111
1111111111111111111111111111111111111111111111111111111111111111111111111111111111111111111111111111
1111111111111111111111111111111111111111111111111111111111111111111111111111111111111111111111111111
1111111111111111111111111111111111111111111111111111111111111111111111111111111111111111111111111111
1111111111111111111111111111111111111111111111111111111111111111111111111111111111111111111111111111
1111111111111111111111111111111111111111111111111111111111111111111111111111111111111111111111111111
1111111111111111111111111111111111111111111111111111111111111111111111111111111111111111111111111111
1111111111111111111111111111111111111111111111111111111111111111111111111111111111111111111111111111
1111111111111111111111111111111111111111111111111111111111111111111111111111111111111111111111111111
1111111111111111111111111111111111111111111111111111111111111111111111111111111111111111111111111111
1111111111111111111111111111111111111111111111111111111111111111111111111111111111111111111111111111
1111111111111111111111111111111111111111111111111111111111111111111111111111111111111111111111111111
1111111111111111111111111111111111111111111111111111111111111111111111111111111111111111111111111111
1111111111111111111111111111111111111111111111111111111111111111111111111111111111111111111111111111
1111111111111111111111111111111111111111111111111111111111111111111111111111111111111111111111111111
1111111111111111111111111111111111111111111111111111111111111111111111111111111111111111111111111111
1111111111111111111111111111111111111111111111111111111111111111111111111111111111111111111111111111
1111111111111111111111111111111111111111111111111111111111111111111111111111111111111111111111111111
1111111111111111111111111111111111111111111111111111111111111111111111111111111111111111111111111111
1111111111111111111111111111111111111111111111111111111111111111111111111111111111111111111111111111
1111111111111111111111111111111111111111111111111111111111111111111111111111111111111111111111111111
1111111111111111111111111111111111111111111111111111111111111111111111111111111111111111111111111111