11111111111111111111
10010100C10001C00101
1E000100010001000001
1C010110000001000101
10111100011000011111
10C10000110001000001
10000100010C010C1CP1
11111111111111111111
