111111111111111111111111111111111111
1E1000100000000010001000000000000011
101010101111101010111010111011111011
10101000C010101010000010001C10001011
101111111010101010111111101110101011
100010001000101010000000100000101011
111010101011101011111110111111101111
100010101010001000000010100010100011
10111010111C111111111010101010111011
101C00101000100000001010001000101C11
101110101011111011111011111110101011
1000101010100000100000100C00C0001011
111010101011101110111110111111111011
1000101010100010001000001C0C10100011
10111010101011101111111010101C101011
100000101010001010000010001000101011
111111101011101011101011111110101011
1000001010001010100010100010P0101011
10111010111C101010111010101111101111
10101010000C101000101010101000100011
101010111111101111101010101010111011
100010000000000000000000100010000011
111111111111111111111111111111111111
111111111111111111111111111111111111
