11111111111111111111
1E10000C000000000011
10111011111111111011
1C001000000010001011
11101111111010101011
10100000001010100011
10111111101110111011
10000000100010001011
10111C11111011101011
10100010000010001011
10101110111110111011
101C0000100000100C11
1C111111101110111111
10001000000010000011
11101111111110111011
10101000100010001011
101010101P1C11111011
10000010001000000011
11111111111111111111
11111111111111111111