1111111111111
1P11000000001
111001CCCC111
10C01100E0001
1111111111111