1111111111111
1C010000000C1
10X0011111C01
1P0011E100001
1111111111111