1111111111111
1C010000000C1
1100001000C01
1P0011E000001
1111111111111