1111111111111
1001000XP0XX1
111001CCCC111
1XC01100E0X01
1111111111111