1111111111111
10010000P0001
111001CCCC111
10C01100E0001
1111111111111